//MAP CONVERTED BY dmm2tgm.py THIS HEADER COMMENT PREVENTS RECONVERSION, DO NOT REMOVE
"ag" = (
/obj/machinery/holopad,
/obj/structure/cable/yellow{
	icon_state = "1-2"
	},
/mob/living/simple_animal/chicken/turkey{
	atmos_requirements = list("min_oxy" = 0, "max_oxy" = 0, "min_tox" = 0, "max_tox" = 0, "min_co2" = 0, "max_co2" = 0, "min_n2" = 0, "max_n2" = 0);
	desc = "A veteran of Nanotrasen's Animal Experimentation Program that attempted to replicate the organic space suit that some hostile entities are known to have exhibited, Tom now serves Nanotrasen as the mascot of the Exploration Crew.";
	health = 200;
	maxHealth = 200;
	melee_damage = 5;
	minbodytemp = 2.7;
	name = "Tom"
	},
/obj/machinery/atmospherics/pipe/simple/supply/hidden/layer2{
	dir = 1
	},
/obj/machinery/atmospherics/pipe/simple/scrubbers/hidden/layer4{
	dir = 1
	},
/obj/effect/turf_decal/edges/borderfloor/black/cee,
/turf/open/floor/mineral/titanium/white,
/area/shuttle/exploration)
"aG" = (
/turf/closed/wall/mineral/titanium,
/turf/open/floor/plating,
/area/shuttle/exploration)
"bg" = (
/obj/machinery/atmospherics/components/unary/vent_pump/on/layer2,
/obj/machinery/light/small{
	dir = 4
	},
/turf/open/floor/mineral/plastitanium,
/area/shuttle/exploration)
"dh" = (
/obj/machinery/computer/crew{
	dir = 1
	},
/obj/structure/railing,
/turf/open/floor/mineral/plastitanium,
/area/shuttle/exploration)
"ex" = (
/obj/effect/turf_decal/stripes/line{
	dir = 8
	},
/turf/open/floor/mineral/plastitanium,
/area/shuttle/exploration)
"fd" = (
/obj/effect/turf_decal/loading_area{
	dir = 8
	},
/obj/machinery/atmospherics/pipe/simple/purple/visible{
	dir = 4
	},
/obj/machinery/door/poddoor/shutters/window{
	id = "exploration2"
	},
/obj/machinery/atmospherics/pipe/simple/supply/hidden/layer2{
	dir = 8
	},
/obj/machinery/atmospherics/pipe/simple/scrubbers/hidden/layer4{
	dir = 8
	},
/obj/machinery/button/door{
	desc = "A remote control switch.";
	id = "exploration2";
	name = "Exploration Shuttle Shutters";
	pixel_y = 22;
	pixel_x = 7
	},
/turf/open/floor/mineral/plastitanium,
/area/shuttle/exploration)
"fY" = (
/obj/structure/sign/nanotrasen,
/turf/closed/wall/mineral/titanium/nodiagonal,
/area/shuttle/exploration)
"gg" = (
/obj/machinery/button/door{
	desc = "A remote control switch.";
	id = "exploration3";
	name = "Exploration Shuttle Shutters";
	pixel_y = -32
	},
/obj/machinery/telecomms/relay/preset/exploration,
/obj/effect/turf_decal/bot,
/turf/open/floor/mineral/plastitanium,
/area/shuttle/exploration)
"gw" = (
/obj/machinery/atmospherics/pipe/simple/purple/visible{
	dir = 6
	},
/obj/machinery/atmospherics/pipe/simple/supply/hidden/layer2{
	dir = 5
	},
/obj/machinery/atmospherics/components/unary/vent_scrubber/on/layer4{
	dir = 4
	},
/turf/open/floor/mineral/plastitanium,
/area/shuttle/exploration)
"hd" = (
/obj/structure/cable/yellow{
	icon_state = "4-8"
	},
/obj/effect/turf_decal/stripes/line{
	dir = 4
	},
/obj/machinery/atmospherics/pipe/simple/scrubbers/hidden/layer4{
	dir = 4
	},
/obj/machinery/atmospherics/pipe/simple/supply/hidden/layer2{
	dir = 4
	},
/turf/open/floor/mineral/plastitanium,
/area/shuttle/exploration)
"hp" = (
/obj/structure/tank_dispenser/oxygen,
/obj/effect/turf_decal/bot,
/obj/structure/railing,
/obj/machinery/light/small{
	brightness = 3;
	dir = 8
	},
/turf/open/floor/mineral/plastitanium,
/area/shuttle/exploration)
"hz" = (
/obj/machinery/atmospherics/pipe/manifold/scrubbers/hidden/layer4{
	dir = 1
	},
/obj/machinery/atmospherics/pipe/simple/supply/hidden/layer2{
	dir = 4
	},
/obj/structure/cable/yellow{
	icon_state = "4-8"
	},
/obj/effect/turf_decal/edges/borderfloor/black/cee,
/turf/open/floor/mineral/titanium/white,
/area/shuttle/exploration)
"is" = (
/obj/machinery/computer/objective,
/turf/open/floor/mineral/plastitanium,
/area/shuttle/exploration)
"jb" = (
/turf/open/floor/mineral/plastitanium,
/area/shuttle/exploration)
"jn" = (
/obj/machinery/light/floor,
/obj/machinery/atmospherics/pipe/simple/scrubbers/hidden/layer4{
	dir = 6
	},
/obj/machinery/atmospherics/pipe/simple/supply/hidden/layer2{
	dir = 10
	},
/obj/effect/turf_decal/stripes/line,
/turf/open/floor/mineral/plastitanium,
/area/shuttle/exploration)
"jv" = (
/turf/closed/wall/mineral/plastitanium/nodiagonal,
/area/shuttle/exploration)
"kr" = (
/obj/machinery/door/poddoor/shutters/window{
	id = "exploration4"
	},
/obj/machinery/button/door{
	desc = "A remote control switch.";
	id = "exploration4";
	name = "Exploration Shuttle Shutters";
	pixel_y = 22;
	pixel_x = 7
	},
/turf/open/floor/plating,
/area/shuttle/exploration)
"kw" = (
/obj/machinery/atmospherics/pipe/simple/supply/hidden/layer2{
	dir = 10
	},
/obj/effect/turf_decal/edges/borderfloor/black/cee,
/turf/open/floor/mineral/titanium/white,
/area/shuttle/exploration)
"nP" = (
/obj/machinery/modular_computer/console/preset/engineering{
	desc = "A stationary computer. for when the silence is too much to bare.";
	name = "Exploration Console"
	},
/turf/open/floor/mineral/plastitanium,
/area/shuttle/exploration)
"pr" = (
/obj/machinery/atmospherics/pipe/simple/purple/visible{
	dir = 10
	},
/obj/machinery/atmospherics/pipe/simple/supply/hidden/layer2{
	dir = 9
	},
/obj/machinery/atmospherics/components/unary/vent_scrubber/on/layer4{
	dir = 8
	},
/turf/open/floor/mineral/plastitanium,
/area/shuttle/exploration)
"rc" = (
/obj/effect/turf_decal/stripes/line{
	dir = 4
	},
/obj/structure/chair/fancy/shuttle,
/turf/open/floor/mineral/plastitanium,
/area/shuttle/exploration)
"rd" = (
/obj/effect/turf_decal/edges/borderfloor/black/cee,
/turf/open/floor/mineral/titanium/white,
/area/shuttle/exploration)
"rj" = (
/obj/machinery/atmospherics/pipe/manifold/scrubbers/hidden/layer4{
	dir = 4
	},
/obj/machinery/atmospherics/pipe/manifold4w/supply/hidden/layer2,
/obj/structure/cable/yellow{
	icon_state = "2-8"
	},
/obj/effect/turf_decal/edges/borderfloor/black/cee,
/turf/open/floor/mineral/titanium/white,
/area/shuttle/exploration)
"rK" = (
/turf/closed/wall/mineral/titanium,
/area/shuttle/exploration)
"sl" = (
/obj/machinery/shuttle/engine/plasma{
	dir = 1
	},
/turf/open/floor/plating,
/area/shuttle/exploration)
"um" = (
/obj/machinery/camera/directional/east,
/obj/effect/turf_decal/stripes/line,
/obj/structure/railing,
/obj/item/storage/box/donkpockets,
/obj/item/storage/box/donkpockets,
/obj/machinery/microwave,
/obj/structure/table,
/obj/machinery/light/small{
	dir = 4
	},
/turf/open/floor/mineral/plastitanium,
/area/shuttle/exploration)
"uq" = (
/obj/structure/chair/fancy/shuttle,
/obj/machinery/button/door{
	desc = "A remote control switch.";
	id = "exploration1";
	name = "Exploration Shuttle Shutters";
	pixel_y = 24
	},
/turf/open/floor/mineral/plastitanium,
/area/shuttle/exploration)
"uV" = (
/obj/machinery/atmospherics/components/unary/vent_scrubber/on/layer4{
	dir = 8
	},
/obj/effect/turf_decal/stripes/line,
/turf/open/floor/mineral/plastitanium,
/area/shuttle/exploration)
"xa" = (
/obj/structure/cable/yellow{
	icon_state = "1-2"
	},
/obj/machinery/atmospherics/pipe/simple/supply/hidden/layer2{
	dir = 1
	},
/obj/machinery/atmospherics/pipe/simple/scrubbers/hidden/layer4{
	dir = 1
	},
/obj/machinery/door/airlock/titanium,
/turf/open/floor/mineral/titanium/white,
/area/shuttle/exploration)
"xN" = (
/obj/structure/closet/emcloset,
/turf/open/floor/mineral/plastitanium,
/area/shuttle/exploration)
"yL" = (
/obj/structure/cable/yellow{
	icon_state = "4-8"
	},
/obj/machinery/atmospherics/pipe/simple/scrubbers/hidden/layer4{
	dir = 4
	},
/obj/machinery/atmospherics/pipe/simple/supply/hidden/layer2{
	dir = 4
	},
/obj/effect/turf_decal/edges/borderfloor/black/cee,
/turf/open/floor/mineral/titanium/white,
/area/shuttle/exploration)
"zl" = (
/obj/effect/turf_decal/stripes/line{
	dir = 1
	},
/obj/effect/turf_decal/delivery,
/obj/machinery/atmospherics/components/unary/plasma_refiner{
	dir = 8
	},
/obj/structure/sign/warning/nosmoking/circle{
	pixel_x = 32
	},
/turf/open/floor/mineral/plastitanium,
/area/shuttle/exploration)
"zS" = (
/obj/effect/turf_decal/stripes/line,
/obj/structure/railing,
/obj/structure/chair/fancy/shuttle{
	dir = 1
	},
/turf/open/floor/mineral/plastitanium,
/area/shuttle/exploration)
"Az" = (
/obj/structure/railing{
	dir = 8
	},
/turf/open/floor/mineral/plastitanium,
/area/shuttle/exploration)
"AF" = (
/obj/structure/closet/crate,
/obj/item/wrench,
/obj/item/pickaxe,
/obj/item/mining_scanner,
/obj/item/radio/headset/headset_exploration,
/obj/item/radio/headset/headset_exploration,
/obj/effect/turf_decal/bot,
/obj/machinery/atmospherics/pipe/simple/purple/visible,
/turf/open/floor/mineral/plastitanium,
/area/shuttle/exploration)
"BV" = (
/obj/structure/railing{
	dir = 8
	},
/turf/closed/wall/mineral/titanium,
/area/shuttle/exploration)
"Df" = (
/obj/machinery/computer/shuttle_flight/custom_shuttle/exploration,
/turf/open/floor/mineral/plastitanium,
/area/shuttle/exploration)
"Ej" = (
/obj/machinery/camera/preset{
	dir = 10
	},
/obj/machinery/button/door{
	desc = "A remote control switch.";
	id = "exploration2";
	name = "Exploration Shuttle Shutters";
	pixel_y = -32
	},
/obj/machinery/vendor/exploration,
/obj/effect/turf_decal/bot,
/turf/open/floor/mineral/plastitanium,
/area/shuttle/exploration)
"EW" = (
/obj/structure/chair/fancy/shuttle{
	dir = 1
	},
/turf/open/floor/mineral/plastitanium,
/area/shuttle/exploration)
"EZ" = (
/obj/structure/chair/fancy/shuttle,
/obj/machinery/button/door{
	desc = "A remote control switch.";
	id = "exploration4";
	name = "Exploration Shuttle Shutters";
	pixel_y = 24
	},
/turf/open/floor/mineral/plastitanium,
/area/shuttle/exploration)
"Io" = (
/obj/effect/turf_decal/stripes/line{
	dir = 1
	},
/obj/effect/turf_decal/bot,
/obj/machinery/power/apc/auto_name/directional/west{
	pixel_x = -24
	},
/obj/structure/cable/yellow{
	icon_state = "0-4"
	},
/obj/machinery/atmospherics/components/unary/portables_connector/visible{
	dir = 4
	},
/obj/machinery/portable_atmospherics/canister/plasma,
/turf/open/floor/mineral/plastitanium,
/area/shuttle/exploration)
"IN" = (
/obj/effect/turf_decal/stripes/line,
/obj/machinery/atmospherics/pipe/simple/scrubbers/hidden/layer4{
	dir = 1
	},
/obj/machinery/atmospherics/pipe/simple/supply/hidden/layer2{
	dir = 1
	},
/turf/open/floor/mineral/plastitanium,
/area/shuttle/exploration)
"Jp" = (
/turf/template_noop,
/area/shuttle/exploration)
"JX" = (
/obj/effect/turf_decal/stripes/line{
	dir = 10
	},
/obj/structure/railing,
/obj/structure/chair/fancy/shuttle{
	dir = 1
	},
/turf/open/floor/mineral/plastitanium,
/area/shuttle/exploration)
"KI" = (
/obj/machinery/atmospherics/pipe/simple/purple/visible{
	dir = 4
	},
/obj/machinery/atmospherics/pipe/simple/supply/hidden/layer2{
	dir = 8
	},
/obj/machinery/atmospherics/pipe/simple/scrubbers/hidden/layer4{
	dir = 8
	},
/turf/open/floor/mineral/plastitanium,
/area/shuttle/exploration)
"KV" = (
/obj/effect/turf_decal/delivery,
/obj/machinery/light/small,
/obj/structure/closet/crate/secure/weapon,
/obj/item/firing_pin/clown,
/turf/open/floor/mineral/plastitanium,
/area/shuttle/exploration)
"Ly" = (
/turf/closed/wall/mineral/plastitanium,
/area/shuttle/exploration)
"LA" = (
/obj/structure/window/reinforced/survival_pod{
	dir = 1
	},
/obj/machinery/atmospherics/components/unary/shuttle/heater{
	dir = 1
	},
/turf/open/floor/mineral/plastitanium,
/area/shuttle/exploration)
"Mf" = (
/obj/effect/turf_decal/loading_area{
	dir = 4
	},
/obj/machinery/atmospherics/pipe/simple/purple/visible{
	dir = 4
	},
/obj/machinery/door/poddoor/shutters/window{
	id = "exploration3"
	},
/obj/machinery/atmospherics/pipe/simple/supply/hidden/layer2{
	dir = 8
	},
/obj/machinery/atmospherics/pipe/simple/scrubbers/hidden/layer4{
	dir = 8
	},
/obj/machinery/button/door{
	desc = "A remote control switch.";
	id = "exploration3";
	name = "Exploration Shuttle Shutters";
	pixel_y = 22;
	pixel_x = -7
	},
/turf/open/floor/mineral/plastitanium,
/area/shuttle/exploration)
"Mq" = (
/obj/machinery/atmospherics/components/unary/vent_scrubber/on/layer4{
	dir = 1
	},
/obj/structure/table,
/obj/effect/turf_decal/edges/borderfloor/black/cee,
/obj/item/paper{
	name = "Derelict Service Fee";
	default_raw_text = <!DOCTYPE html><html lang="en"><head>    <meta charset="UTF-8">    <meta name="viewport" content="width=device-width, initial-scale=1.0">    <title>Ship Repair & Restoration</title></head><body>    Ship Repair & Restoration    <p><strong>Receipt Number:</strong> #DS2025-045</p>    <p><strong>Repair Date:</strong> 2025-01-28</p>    <p><strong>Client:</strong>  [Unknown]</p>    <p><strong>Repair Facility:</strong> SS13 Station Exploration Bay</p>   <font face="Nyala" color=#FFF size=4><i>Ship Classification; </i></font>    Ship Name: [Unidentifiable]    Ship Type: KEROWYN M9 Transport Frigate    Serial Number: ETH-413-SS7    Condition Upon Arrival: Severe Hull Damage, Power Failure, Multiple System Failures,     Repair & Restoration Work Completed:    -      Hull Repairs: Full structural patching and re-sealing of outer hull. Replaced damaged panels and re-welded fractures in the aft section.-        Power Restoration; Complete overhaul of the energy net. Replaced primary APC components and restored shutter system.-         Life Support Systems; Restored atmospheric controls, repaired oxygen pumps, and replaced faulty Plasma scrubbers.-      Engine Restoration: Engine recalibration, fuel line repairs, and reconfiguration of thrusters.-        Navigation Systems: Full diagnostics of the navigation systems. Replaced damaged sensors and recalibrated command centre.-       Minor Cosmetic Repairs: Cleaned and repainted the external areas. Removed debris and excess corrosion.     Additional Information:         Extreme Structural Damage rendered multiple    LV-PlasTurrets inoperatble     Ship Production ceased 324yr,modern technology may not be suitable for restoration<font face="Nyala" color=#FFF size=4><i> £325,000cr Withdrawn from Local Account </i></font>
	},
/turf/open/floor/mineral/titanium/white,
/area/shuttle/exploration)
"Mz" = (
/obj/structure/railing{
	dir = 4
	},
/turf/open/floor/mineral/plastitanium,
/area/shuttle/exploration)
"ON" = (
/obj/effect/turf_decal/stripes/line{
	dir = 1
	},
/obj/machinery/atmospherics/pipe/manifold/purple/visible{
	dir = 1
	},
/obj/structure/cable/yellow{
	icon_state = "1-8"
	},
/obj/machinery/atmospherics/pipe/simple/supply/hidden/layer2{
	dir = 1
	},
/obj/machinery/atmospherics/pipe/simple/scrubbers/hidden/layer4{
	dir = 1
	},
/turf/open/floor/mineral/plastitanium,
/area/shuttle/exploration)
"OS" = (
/obj/structure/railing{
	dir = 4
	},
/turf/closed/wall/mineral/titanium,
/area/shuttle/exploration)
"Pi" = (
/obj/machinery/door/poddoor/shutters/window{
	id = "exploration1"
	},
/obj/machinery/button/door{
	desc = "A remote control switch.";
	id = "exploration1";
	name = "Exploration Shuttle Shutters";
	pixel_y = 22;
	pixel_x = -7
	},
/turf/open/floor/plating,
/area/shuttle/exploration)
"PS" = (
/obj/machinery/computer/rdconsole{
	dir = 1
	},
/obj/structure/railing,
/turf/open/floor/mineral/plastitanium,
/area/shuttle/exploration)
"QI" = (
/obj/machinery/atmospherics/pipe/manifold4w/purple/visible,
/obj/machinery/atmospherics/pipe/manifold/scrubbers/hidden/layer4,
/obj/machinery/atmospherics/pipe/manifold/supply/hidden/layer2,
/turf/open/floor/mineral/plastitanium,
/area/shuttle/exploration)
"Rq" = (
/obj/effect/turf_decal/stripes/line{
	dir = 8
	},
/obj/structure/chair/fancy/shuttle,
/turf/open/floor/mineral/plastitanium,
/area/shuttle/exploration)
"Sh" = (
/obj/effect/turf_decal/stripes/line{
	dir = 6
	},
/obj/structure/railing,
/obj/structure/chair/fancy/shuttle{
	dir = 1
	},
/turf/open/floor/mineral/plastitanium,
/area/shuttle/exploration)
"Si" = (
/obj/machinery/atmospherics/pipe/simple/scrubbers/hidden/layer4{
	dir = 1
	},
/obj/machinery/atmospherics/pipe/simple/supply/hidden/layer2{
	dir = 1
	},
/obj/effect/turf_decal/edges/borderfloor/black/cee,
/turf/open/floor/mineral/titanium/white,
/area/shuttle/exploration)
"Uj" = (
/obj/effect/spawner/structure/window/shuttle,
/turf/open/floor/plating,
/area/shuttle/exploration)
"UC" = (
/obj/structure/closet/crate/science,
/obj/item/multitool,
/obj/item/storage/toolbox/mechanical,
/obj/item/gps/mining,
/obj/item/stack/sheet/mineral/plasma/five,
/obj/item/circuitboard/computer/shuttle/exploration_shuttle,
/obj/effect/turf_decal/bot,
/obj/machinery/atmospherics/pipe/simple/purple/visible,
/turf/open/floor/mineral/plastitanium,
/area/shuttle/exploration)
"US" = (
/obj/structure/extinguisher_cabinet{
	pixel_x = -32;
	pixel_y = -1
	},
/turf/closed/wall/mineral/titanium/nodiagonal,
/area/shuttle/exploration)
"Xc" = (
/obj/structure/fans/tiny,
/obj/machinery/door/airlock/external/glass,
/obj/docking_port/mobile{
	dir = 4;
	dwidth = 5;
	height = 7;
	id = "exploration";
	name = "Exploration Shuttle";
	port_direction = 8;
	shuttle_object_type = /datum/orbital_object/shuttle/custom_shuttle;
	width = 13
	},
/obj/structure/cable/yellow{
	icon_state = "4-8"
	},
/obj/machinery/atmospherics/pipe/simple/scrubbers/hidden/layer4{
	dir = 4
	},
/obj/machinery/atmospherics/pipe/simple/supply/hidden/layer2{
	dir = 4
	},
/turf/open/floor/mineral/plastitanium,
/area/shuttle/exploration)
"Xd" = (
/turf/closed/wall/mineral/titanium/nodiagonal,
/area/shuttle/exploration)
"Xe" = (
/obj/machinery/atmospherics/components/unary/vent_pump/on/layer2,
/obj/machinery/light/small{
	brightness = 3;
	dir = 8
	},
/turf/open/floor/mineral/plastitanium,
/area/shuttle/exploration)
"Xu" = (
/obj/structure/window/reinforced/survival_pod{
	dir = 1
	},
/obj/machinery/atmospherics/components/unary/shuttle/heater{
	dir = 1
	},
/turf/open/floor/plating,
/area/shuttle/exploration)
"Yp" = (
/obj/machinery/atmospherics/components/unary/vent_pump/on/layer2{
	dir = 1
	},
/obj/machinery/newscaster{
	pixel_x = 32;
	pixel_y = 1
	},
/obj/machinery/recharger,
/obj/structure/table,
/obj/effect/turf_decal/edges/borderfloor/black/cee,
/turf/open/floor/mineral/titanium/white,
/area/shuttle/exploration)
"Zv" = (
/obj/machinery/atmospherics/components/unary/vent_pump/on/layer2{
	dir = 4
	},
/obj/effect/turf_decal/stripes/line,
/turf/open/floor/mineral/plastitanium,
/area/shuttle/exploration)

(1,1,1) = {"
Jp
Jp
Jp
rK
BV
Az
BV
Xd
Xc
Xd
rK
rK
Pi
Ly
Ly
Ly
Ly
"}
(2,1,1) = {"
rK
rK
rK
rK
rK
rK
Xd
hp
hd
Uj
xN
Xe
gw
LA
sl
Jp
Jp
"}
(3,1,1) = {"
Jp
Uj
Uj
aG
Ej
Xd
uq
zS
yL
Xd
Xd
Xd
fd
jv
jv
Ly
Jp
"}
(4,1,1) = {"
Jp
Uj
Df
jb
Zv
PS
rc
Sh
hz
Mq
US
Io
KI
KV
jv
Ly
Jp
"}
(5,1,1) = {"
Jp
Uj
nP
EW
jn
IN
Si
Si
rj
ag
xa
ON
QI
UC
Xu
sl
Jp
"}
(6,1,1) = {"
Jp
Uj
is
jb
uV
dh
Rq
JX
kw
Yp
Xd
zl
KI
AF
jv
Ly
Jp
"}
(7,1,1) = {"
Jp
Uj
Uj
aG
gg
Xd
EZ
zS
rd
Xd
Xd
Xd
Mf
jv
jv
Ly
Jp
"}
(8,1,1) = {"
rK
rK
rK
rK
rK
rK
fY
um
ex
Uj
xN
bg
pr
LA
sl
Jp
Jp
"}
(9,1,1) = {"
Jp
Jp
Jp
rK
OS
Mz
OS
Xd
Uj
Xd
rK
rK
kr
Ly
Ly
Ly
Ly
"}
